00000000000
00555500000
05555555000
05550555000
05550055500
00555555500
00055555500
00055555500
00555555500
00555555000
05555555000
05555550000
05555500000
00555000000

