00000000000
00000000000
00000000000
00055550000
00555555500
00555055500
00555005550
00055555550
00005555550
00005555550
00055555550
00055555500
00555555500
00555555000
00555550000
00055500000

