66666666666
00000000006
06666666606
06000000606
06066660606
06060060606
06060060606
06060060606
06060060606
06060660606
06060000606
06066666606
06000000006
06666666666