00000000000
01100000110
01100100110
01100100110
01100100110
01100000110
00001110000
01100000110
01101110110
01100000110
01101110110
00000000000
01111111110
00000000000