00000000000
44444444444
44111111144
41411111414
41141114114
41114141114
41111411114
41111611114
41111611114
04111611140
00411611400
00041614000
00004640000
00000400000

