00000000000
00000000000
00000022000
00000220000
00011211000
00111111100
00111111110
01111111110
01111111110
01111111110
01111111110
01111111110
01111111110
00111111100
00011111000
00001110000
00000000000
00000000000
00000000000
00000000000
00000000000
00000000000
00000000000
00000000000
00000000000
00000000000
00000000000
00000000000






